S████████████████████
    █   █ █       █ █
█ █████ █ █ █████ █ █
█ █   █     █ █     █
█ █ █ █ ███ █ █ ███ █
█ █ █ █   █   █ █   █
█ █ ███ █ █████ ███ █
█       █ █     █   █
█████ █ █████████ █ █
█   █ █   █   █   █ █
█ █ █ █ █ █ ███ █ █ █
█ █   █ █ █   █ █ █ █
█ █ █████ █ █ █ ███ █
█ █ █ █ █   █ █ █   █
█ ███ █ █████ ███ ███
█ █   █         █   █
█ ███ ███████ ███ ███
█ █ █ █       █ █   █
███ █ █ ███ █ █ ███ █
█         █ █ █     E
█████████████████████
