S████████████████████████████████████████████████████████████████████████████████
      █ █     █   █           █             █             █ █                 █ █
█ █ ███ ███ ███ ███ █████████ █ ███ ███ ███ █ █████ ███ ███ ███████ █████ ███ █ █
█ █     █   █ █   █ █     █     █   █ █ █     █     █     █       █   █ █   █   █
███ █ █ █ ███ █ ███████ █████ █ ███ █ █████ ███████ ███████ █ █ ███ █ █ █████ ███
█ █ █ █   █     █ █           █ █ █       █ █       █   █   █ █     █ █     █   █
█ ███ █████ █ ███ █ █ █████ ███ █ █ █ █████████ ███ █ █████████ █████ ███ █████ █
█     █     █ █     █ █   █   █   █ █   █   █ █   █ █ █ █   █   █   █ █ █     █ █
███ ███ █ █████ ███████ █████ ███ █ █████ ███ ███████ █ █ █ ███████ █ █ █ █ ███ █
█ █   █ █   █   █ █     █   █   █ █ █     █ █   █ █       █ █ █ █     █   █   █ █
█ ███ █████ ███ █ █ ███ █ █ ███████ ███ ███ ███ █ ███ ███ █ █ █ ███ █████ █ █ ███
█ █   █       █   █   █   █ █     █   █   █       █ █   █ █     █ █ █     █ █   █
█ █ █████ █ █████ ███ ███████ ███████ █ █ ███ ███ █ █ █ █████ ███ █ █████████ █ █
█ █   █ █ █ █   █ █ █           █       █ █   █ █   █ █   █ █   █   █         █ █
█ █ ███ ███ ███ ███ █ ███ █████ ███ █ █████████ ███ █ █████ █ █ ███ █ █ ███ █ █ █
█       █   █ █ █     █ █     █ █   █     █ █               █ █   █   █ █   █ █ █
█ █████ ███ █ █ ███ ███ █ █████ ███ █ █ ███ █████ ███ █████ █ █ █ █ ███ ███ █████
█     █ █ █         █ █     █   █   █ █ █ █   █     █ █     █ █ █ █ █   █   █   █
███ █ ███ █ █████████ █ █ █ ███ ███ ███ █ █ ███ ███ █ ███ █ █████████ █████████ █
█   █ █ █           █ █ █ █ █ █     █       █ █   █ █ █   █ █ █     █   █ █ █   █
█ ███ █ █████ █████ █ ███ ███ █ █ ███ ███████ █ █ █ ███ ███ █ █ █████ ███ █ ███ █
█ █       █     █       █ █ █ █ █   █ █ █ █     █ █   █   █     █ █       █   █ █
███ █████ ███████ █████ ███ █ █ █ █████ █ █████ █ █ ███ ███████ █ ███ ███ ███ █ █
█       █ █ █   █ █   █ █       █     █         █ █   █ █     █   █   █   █     █
█ ███ ███ █ █ ███████ ███ █ ███ ███ ███ ███ ███ ███ █████ █ ███ ███ █ █████ ███ █
█   █ █   █     █   █ █   █   █ █     █ █     █ █       █ █ █ █     █   █ █ █ █ █
███ █ █████ █████ ███ █████ ███████ █████████ ███ ███ █ █ ███ ███ █ ███ █ █ █ ███
█   █     █ █     █ █   █   █   █             █ █ █   █ █     █   █ █         █ █
█████ █ █ █ █ █ █ █ █ ███ ███ █ ███ ███ █████ █ ███████ ███ ███ █ █████ ███ ███ █
█     █ █ █ █ █ █ █     █     █ █ █   █   █ █ █ █   █   █   █   █ █       █ █   █
█ █████ █ █ █ ███████ █ █ ███ ███ █ █████ █ ███ █ █████████ █ █████████████ ███ █
█   █ █ █       █     █     █   █   █   █   █               █   █ █ █ █ █ █   █ █
█ ███ █ ███ █ ███ █████████ ███ ███████ █ █ ███ ███ █ ███ ███████ █ █ █ █ █ ███ █
█ █   █ █   █   █     █ █   █   █     █   █       █ █ █       █ █   █ █   █     █
█ █ █ █ ███ █████ █████ █████ ███████ ███ ███ █████ █ ███ █ ███ ███ █ █ █ ███ █ █
█ █ █   █ █ █ █     █   █ █ █   █   █   █ █   █ █   █ █ █ █ █     █     █ █ █ █ █
█ ███ █ █ █ █ █ █ █████ █ █ ███ █ █ █ ███ █████ ███████ █ █ █ ███ █ ███████ █ █ █
█   █ █ █       █   █         █ █ █   █   █ █   █ █     █ █   █ █     █ █     █ █
█ ███ █ ███ █ █████ █ █████ █ █████ ███ ███ ███ █ █ ███████ █ █ █████ █ █ █████ █
█ █   █   █ █   █       █   █   █                       █   █       █ █     █   E
█████████████████████████████████████████████████████████████████████████████████
