S████████████████████████████████████████
        █ █   █   █ █ █       █       █ █
███ █ ███ ███ ███ █ █ █ ███ █████ █████ █
█   █   █   █ █     █   █   █   █ █     █
█ █ █ ███ ███ █████ ███ █ █ █ █ █ █ ███ █
█ █ █   █     █       █ █ █   █ █     █ █
█ █████ ███ ███ █ █ ███ █████ █████ ███ █
█     █   █ █   █ █ █       █ █ █ █ █   █
█ ███ █ ███ █ ███ ███ █ █ █ ███ █ █ ███ █
█   █ █     █ █       █ █ █ █         █ █
█ ███████ █████ █████ █ ███ █ █ ███████ █
█     █       █   █   █   █ █ █ █   █ █ █
█ ███ █ █ █ █ █ █████ ███████ ███ ███ █ █
█ █   █ █ █ █   █         █   █         █
█ ███ █████ █ ███ █████ █ █ ███ █████ █ █
█   █ █   █ █   █   █   █     █   █   █ █
███ █████ ███ █████████████ █ ███ ███ ███
█     █       █     █   █ █ █ █     █   █
███ ███ █ █ █ █ █ █████ █ █ █ ███ █ █ ███
█     █ █ █ █   █     █     █   █ █ █   E
█████████████████████████████████████████
